


       NO   ./maps/no.xpm



    SO     ./maps/so.xpm


WE   ./maps/we.xpm

EA     ./maps/ea.xpm


F   220,100,0 


C    225,30,0 


     11 111    1111
    10011101111111111111111111    111111111111111111111111111
    1111000001110000000000001            
        100100000000000000001111111 
11111111111000000000000000000011111111
11111111011000001110000000000001 
100000000011000001110111111111111 
111101111111011100000010001 
11111111111111011101010010011
       11000000110101011111111111111
111111111000000001100000010001 
10000000000000001101010010001 
110000011101010111110111100111 
1111111   1111111111N11111111 
11111111   11111111111111111



