    111  1111
    1111111111111111111111110111    
   11011111011
111111 1011
111   11111
11   10E1111
  1111111111
   11   1111