


       NO   ./maps/key.xpm



    SO     ./maps/key.xpm


WE   ./maps/key.xpm

EA     ./maps/key.xpm


F   220,100,0 


C    225,30,0 


1111111111111111111111111
1000000000110000000000001
1011000001110000000000001
1001000000000000000000001
1111111110110000011100001
1000000000110000011101111
1111010000000101110000001
1111011111111101110101011
1100000011010101110000001
1000000000000000110000001
1000000000000100110101001
1100000111010101111101111
1111011111101011011111111
1111111111111111111111111



