
F  10,  220,21      

       NO    /Users/hasserao/Desktop/cub3d/maps/   n   o   .png







    

SO    /Users/hasserao/Desktop/Cub3D/maps/so.png
  


WE /Users/hasserao/Desktop/Cub3D/maps/we.png 


EA    /Users/hasserao/Desktop/Cub3D/maps/ea.png



C  0,50,120


111111111        
110101111
111111     111
11N111  1111
111111111111111








