
 F    10,   220,215



       NO /Users/hasserao/Desktop/Cub3D/maps/no.png




    

SO    /Users/hasserao/Desktop/Cub3D/maps/so.png



WE /Users/hasserao/Desktop/Cub3D/maps/we.png 

EA    /Users/hasserao/Desktop/Cub3D/maps/ea.png


SOFG    /Users/hasserao/Desktop/Cub3D/maps/so.png

C  0,50,120


1111111111
110101111
11111N     111
10111  11111
11111111111111111







