


       NO /Users/otait-ta/Desktop/Cub3D/maps/no.png



    SO    /Users/otait-ta/Desktop/Cub3D/maps/no.png


WE  /Users/otait-ta/Desktop/Cub3D/maps/no.png

EA    /Users/otait-ta/Desktop/Cub3D/maps/no.png


F   220,100,0 


C    225,30,0 


11111111
10000001
100S0001
10000001
10010001
10000001
11111111



