


      NO  ./maps/cat.xpm



    SO     ./maps/cat.xpm


WE   ./maps/cat.xpm

EA     ./maps/cat.xpm


F 220,100,0
C 225,30,0



111111111111111
100000000000001
100000000000001
1000001100111111
10000N0001    101
1000000011111111
100000000000001
111111111111111

