


       NO /Users/hasserao/Desktop/Cub3D/maps/no.png



    SO    /Users/hasserao/Desktop/Cub3D/maps/so.png


WE  /Users/hasserao/Desktop/Cub3D/maps/we.png

EA    /Users/hasserao/Desktop/Cub3D/maps/ea.png


F   50,50,50


C    0,50,100


11111111111111111111
10000000000000000001
10000000001110000001
10011111111111111101
10010000000000000001
10010000000000000001
1001000S000000000001
10010000000000000001
10010000000000000001
10011111111111111101
100000000001110000001
10000000000000000001
11111111111111111111



