
F    10,  220,21      

       NO    /Users/hasserao/Desktop/cub3d/maps/   n   o   .png







    

SO    /Users/hasserao/Desktop/Cub3D/maps/so.png
  


WE /Users/hasserao/Desktop/Cub3D/maps/we.png 


EA    /Users/hasserao/Desktop/Cub3D/maps/ea.png



C    10,50,120


111111111       
10101111
11N111     111
110111  1111
11111111111111








