


       NO /Users/hasserao/Desktop/Cub3D/maps/NO.png



    SO    /Users/hasserao/Desktop/Cub3D/maps/SO.png


WE  /Users/hasserao/Desktop/Cub3D/maps/WE.png

EA    /Users/hasserao/Desktop/Cub3D/maps/EA.png


F   0,220,190


C  250,150,47


 1111111111111
100000000000001 
100000000000001 
10000000N001111 
100000000001   11
 1111111111111 


