       1111111
       1100011
11111110001N01
111   10000011
111   10000111
 11111000111