    111  11111
   11011111011
1111111001
111   10111
111   10E1111
  11111111111
   11   1111