


       NO   /Users/hasserao/Desktop/Cub3D/maps/cat.xpm



    SO      /Users/hasserao/Desktop/Cub3D/maps/cat.xpm


WE    /Users/hasserao/Desktop/Cub3D/maps/cat.xpm

EA      /Users/hasserao/Desktop/Cub3D/maps/cat.xpm


F   220,100,0 


C    225,30,0 


     111 11111111
    100111000011011111111111111    111111111111111111111111111
    1111000001110000000000001            
        100100000000000000001111111 
11111111111000000000000000000011111111
11111111011000001110000000000001 
100000000011000001110111111111111 
11110111111111011100000010001 
11111111111111011101010010001
       11000000110101011111111111111
111111111000000001100000010001 
10000000000000001101010010001 
11000001110101011111011110N0111 
1111111   11111111111111111111 
11111111   111111111111111111



