


      NO  ./maps/cat.xpm



    SO     ./maps/cat.xpm


WE   ./maps/cat.xpm

EA     ./maps/cat.xpm


F 220,100,0
C 225,30,0



111111111111111
100000000000001
100000000000001
100000110000001
10000N000000001
100000001100001
100000000000001
111111111111111
