


      NO  ./maps/cat.xpm



    SO     ./maps/cat.xpm


WE   ./maps/cat.xpm

EA     ./maps/cat.xpm


F 220,100,0
C 225,30,0


                  111
             111111011111111
1             100000000000001
111          1000000000000011                 11
1101         1000001100111101                101    1
  11        10000N00001  111                  1
             100000001111111
             10000000000001
              11111111111111     
                    1         1                                                                         1               
            1      1011   
                    1        