


       NO /Users/otait-ta/Desktop/Cub3D/maps/NO.png



    SO    /Users/otait-ta/Desktop/Cub3D/maps/SO.png


WE  /Users/otait-ta/Desktop/Cub3D/maps/WE.png

EA    /Users/otait-ta/Desktop/Cub3D/maps/EA.png


F   50,50,50


C    0,50,100


 1111111111111
100000000000001 
100000000000001 
10000000N000001 
100000000000001
 1111111111111 


