


      NO  ./maps/cat.xpm



    SO     ./maps/cat.xpm


WE   ./maps/cat.xpm

EA     ./maps/cat.xpm


F 220,100,0
C 225,30,0



11111111111111
100000000000001
100000000000001
1000001100111101
10000N00001  11111
1000000011111101
100000000000001
111111111111111
