


       NO /Users/otait-ta/Desktop/Cub3D/maps/cat.xpm



    SO    /Users/otait-ta/Desktop/Cub3D/maps/cat.xpm


WE  /Users/otait-ta/Desktop/Cub3D/maps/cat.xpm

EA    /Users/otait-ta/Desktop/Cub3D/maps/cat.xpm


F   220,100,0 


C    225,30,0 


1111
1001
1001
1001
1N01
1111



