


       NO   ./maps/key.xpm



    SO     ./maps/key.xpm


WE   ./maps/key.xpm

EA     ./maps/key.xpm


F   220,100,0 


C    225,30,0 


 111111111111111111111111111
100001000000000000000000001
100001000000000000000000001
100001000000000000000000001
100001000000000000000000001
100001000000100000000000001
100001000000010000000000001
100001000000000000000000001
100001000000101000000000001
100001000000000000000000001
100001000000000000000000001
111111111111111111111111111



