
C 10,50,120
      








    

SO    /Users/otait-ta/Desktop/Cub3D/maps/so.png
  


WE /Users/otait-ta/Desktop/Cub3D/maps/we.png 

       NO     /Users/otait-ta/Desktop/cub3d/maps/   n   ,o   .png     
F 10,50,120

EA    /Users/otait-ta/Desktop/Cub3D/maps/so1.png




111111111
100000001
100N00001
1000110001
100000001
11111111








